################################################################################################
#############################################.##################################################
#############################################.##################################################
#############################################.##################################################
#############################################.##################################################
#############################################.##################################################
#############################################.##########........################################
#############################################.##########........#.##############################
#############################################.##########........#.##############################
#############################################.#......###........+.##############################
#############################################.#......###........#.##############################
#############################################.#......###........#.##############################
#############################################.+......###........#.#################....#########
#############################################.#......###........#.#################....#########
#######################################.....#.###################.#################....#########
#######################################.....#.###################.#####.........###....#########
#######################################.....#.###################.#####.........#.+....#########
########################.........######.....+.#####....##########.#####.........+.#....####....#
########################.........######.....#.....+....##########.#####.........#.#....####....#
########################.........############..####....########...###############.#....####....#
########################.........#.##########..####....#######..#################.###+#####....#
########################.........#.+........#..####....#....##..#######......#............+....#
########################.........+.#........#..####....#....#...#######......#.#.####.###.######
##################################.#........#..####....#....#...#######......+.#.###....#.##.###
###.........#############....#.....#........#..####....#....+....######......#.#.....####.##...#
###.........#############....#.#.#.#........#..####....#....#.#..#############.#......###.##.#.#
###.........#############....#.....##+#####+#..####+#+#######.#..###############.##.#.#...##.#.#
###.........#############....#.....#....###................##....##.........####......#.#.##.#.#
###.........#############....+.###.#..............#######.........#.........##...............#.#
###.........#...############+#.#............#.#...#######.......#.+.........##.##..####....#...#
###.........###.#.........#..#.#.#...##........#..#########.###.#.#.........##.##......##..#.#.#
###.........#...#.........#..#.....#....###.##.#..######..........#.........##.##########..#.#.#
###.........#.#.#.........+..#.#.#...#..###.......#########+###.#.####+##+####.#........#..#.#.#
########+####.#.#.........#..........##.###.##.##.######....###.....##.........#........#..#...#
##.#.##.........+.........######+#.#..............######....###.#...##...#.....#........#....#.#
##...##.#.###.###.........#......+.#.######.############....###.######...#.#.###........+....#.#
##.#.##.#.###.###.........#......#.#........############....###.######..#....############..#.#.#
##......#.......#.........#......#.#........############....###.######..#..######....##....#.#.#
##.##...###.###############......#...######.############....###.######..#..######.#......#.#.#.#
#.....#.###.####.##########......#...######+######....#########.######..#..####...#..#.......#.#
##..#...###.####.##########......#...#.........###....#########.##########.####.#........#.#.#.#
##..###.########.##########......+...#.........###....#########.##.......+.####.#.########.#.#.#
##....#.##.....#.#....#####......#...#.........#.#....#########..+.......#.####.#.#.....##.....#
###......#.....#.#....#########+##.#.#.........#.#....#......+..##.......#.####.#.#.....+...#..#
###..#.#.#.....#.+....#######.#......#.........#.##+###......##.##.......#.####...#.....##..####
###..#...#.....#.#....#######.#....###.........+.#...##......##.##.......######.###.....##.#####
###..#.#####+###.############...##.###.........#....###......##.##.......######.###.....#..#####
#....#.............................###.........#......+......##.##.......######.###.....#..#.###
####+#+######.###.#.##..#####.##....##########+#.###########+##..+.......######.###.....##.#.###
##.....+.........................................#.....+........######+#+#......###.....##.#.###
##.....######.#.#.##########+###.#.######+#...##.+.....#.............#.#..############+###.#.###
##.....########.####.........###...#......+......#.....+.#######.....#.##.#########.#........###
##.....#######..#.##.........###.#.#......###..#.#.....#.#######.###....#.#########.#..#.#.....#
##.....#######..#..#.........#...#.#......#......#.....#.#######....................#....#.#####
##.....#######.....+.........###.#.+......+....#########.#######.#####.#####.######.#....#.##..#
##.....#######...###.........###...#......###..##############....##...........................##
##.....#######.....#.........####.##......###........................###.#####..#.###########.##
##.....#######.#.#.#.........#....##......##########################.........#......############
##############.....###########.##..+......###############################.##....##..############
################################################################################################
